11111111111111111111111111111111111
1P1000001C00000000000000000000000C1
10100B00111111000000R00001111111001
100000000000000G00000000000001C1C01
10100011110010100111111100100101011
10100000C1001C1001C00000001000010E1
10111111110011100111111111100001111
1000000000000000000000000000G0000C1
10010010001111111111111100011110001
1001CC100000000C1C0000000001CC10001
10011110B0111111111111110B010010001
1C0000000000000000000000000000000C1
11111111111111111111111111111111111