11111111111111111111111111111111111
1P1000001C0000000000000000000000001
10100000111111000000000001111111001
1I0000000000000000000000000001C1C01
10100011110010100111111100100101011
10100000C1001C1001C00000001000010E1
11111111111111111111111111111111111