11111111111111111111111111111111111
101000001C0000000000000000000000001
1010000011111100000E000001111111001
100000000000000000000000000001C1C01
10100011110010100111111100100101001
10100000C1001C1001C0000000100001E01
11111111111111111111111111111111111