11111111111111111111111111111111111
1S01000001C000000000000000000000001
10010000011111100000000000111111101
1000000000000000000000000000001C1C1
10010001111001010011111110010010101
100100000C1001C1001C0000000100001E1
11111111111111111111111111111111111