111111111111111111111111111111111111
1P1000001C00000000000000000000000011
101000001111110000000000011111110011
1I0000000000000000000000000001C1C011
101000111100101001111111001001010111
10100000C1001C1001C00000001000010E11
111111111111111111111111111111111111
111111111111111111111111111111111111