111111111111111111111111111111111111111111111111111111
100000000000000000000000000000000000000000000000000001
100000000000000000000000000000000000000000000000000001
100000000000100000000000000000111111111111111100000001
100000000001000000000000000000000000000000000100000001
100000000010000000000000000000000000000000001100000001
100000000100000000000000000000000000000000110000000001
100000001000000000100000000000000000000011000000000001
100000010000000000100000000000000000001100000000000001
100000111111111111111111000000000000110000000000000001
100000000000000000100000000000000001100000000000000001
100000000000000000100000000000000110000000000000000001
100000000000000000100000000000011000000000000000000001
100000000000000000100000000000111111111111111000000001
100000000000000000000000000000000000000000000000000001
100000000000000000000000000000000000000000000000000001
100000000000000000000000000000000000000000000000000001
111111111111111111111111111111111111111111111111111111