11111111111111111111111111111111111111111111111
1P00C000C00C00C0C00000C0000000000C00C00C0000001
1C1111111C11111111000001111111C1111111000010001
10100000101000000100C00100000101000001000C10001
1C1111111C11111111000001111111C111111100001C001
100000000000000000000R00000000000000000000100C1
1C1111111C1000C00111111100000100111111111011111
100000000010000001000001000001C00000C00000000C1
1C0000C000111110C1111111001111000000000C0000001
100000000C10000000000000000001000C0000000C00001
1C11111110100110000B000001100101111111000000001
101000001C0001C0000000000C100001000001C000G0001
1C111111100001111111111111100001111111000C10001
10C0C0C0C0C0C0C0C0C0C0C0C0C0C0C0C0C0C0C0C010E01
11111111111111111111111111111111111111111111111