1111111111111111111111111111111111
1000000000000000000000000000000001
10100101E0100000101001000000010101
1110010010101010001001000000010101
1P100000000000000000000000000C0001
1111111111111111111111111111111111